10
10
1
2
1111111111
1901901901
1001001001
1001001801
1001000001
1001800001
1000800001
1000001111
1008090001
1111111111