10
10
1
2
1111111111
1401401401
1001001001
1001001201
1001000001
1001200001
1000200001
1000001111
1002040001
1111111111