10
10
2
2
1111111111
1110001001
1402001001
1110201001
1411241001
1010401111
1206224111
1000400111
1111111111
1111111111