10
10
2
2
1111111111
1110001001
1908001001
1110801001
1911891001
1010901111
1808889111
1009900111
1111111111
1111111111