9
8
2
2
00111110
11100010
14020010
11102010
14112410
10104011
12062241
10004001
11111111
